---------------------------------------------------------------------------------------
|                                       |                                             |
|                                       |                                             |
|  S         ----------------           |                                             |
|                                       |                               S             |
|                                       |                                             |
|                                       |              |                              |
|                                       |              |                              |
|                                       |              |                              |
|                                       |              |------------------------------|
|                         |             |              |                              |
|                         |             |              |                              |
|                         |             |              |                              |
|            -------------|                            |                              |
|                         |                            |                              |
|                         |                            |                              |
|                         |                            |                              |
|                         |                            |                              |
|                         |-----------------------------                              |
|      S                                                                  S           |
|                                                                                     |
|                                                                                     |
|                                                                                     |
|                                                                                     |
|                                                                                     |
|                                                                                     |
---------------------------------------------------------------------------------------