----------------
|              |
|              |
|              |
|              |---------------|
|                              |
|     S                        |
|                              |
|                              |
|                              |
--------------------------------